111111111111
1C000E000001
1P0000000001
100000000001
100000000001
100000000001
100000000001
100000000001
100000000001
111111111111