1111111111111111111111111111111
100001001E1C0001001000010010001
101000010011110001001000100C111
1P10010010100100101010010010011
101C0000C0100000100010010100101
1000000000000000000C00000100001
10001000CC010010010000100C00101
1000000CC0001010010010001001001
1001001000101010001C00101010C01
1000000000100C01101001000101001
1000CCCC110010001000100100C0011
100000000000000000000C0000C0001
1111111111111111111111111111111