1111111111111111
1000000000000011
101C000000C00111
10C0000000000111
1P000C0000000111
1000000000000111
1C000000C0001111
100C000000C01111
1000000000000111
1C00000000001111
1000000000000111
1C000C000C011111
1000000000000111
10111111111E0111
1111111111111111