1111111111111111
100000M0M0000011
101C0MM0M0C00111
10C0000000000111
1P000C000M000111
100M00M0000M0111
1C000000C0001111
100C00M000C01111
100000M00000M111
1C0M00000M001111
1M000MMM00000111
1C000C000C011111
1M0000000000M111
10111111111E0111
1111111111111111