1111111111111111111111111111111111
1E0000000000M00C00000C000000M00001
1010M1010010000010100100000M010101
1010010010101010001001000000010101
1P0000000CM0C0000000000M00000000C1
1111111111111111111111111111111111