1111111111111111111111111111111
1000000000000000000000000000PE1
1011111111111111111111111111111
100000M0000000000000M00000000C1
1000000000M000M000000000000M0C1
1111111111111111111111111111111