1111111111111111111111111111111
100001001E1C00010010M001M010001
101M00010011110001M01000100C111
1P110100101MM100101010010010011
111C1000C010M0M01000100101001M1
1M00000M00000000000C000M0100001
1M001000CC010010010000100C00101
1M0M000CCM001010010010001001001
1M01001000101010001C00101010C01
100M000000100C01101001000101001
1000CCCC110010001000100100C0011
100M000MMM00000000000C0000C0MM1
1111111111111111111111111111111