1111111111
1PCE000001
10000M0001
100M000C11
1111111111